10
31
20
2222222221111144444333411111111
2222222222233221144444434441111
1222222222222222224444414444444
3333333333332222222441111333333
0000000000000222224111333333333
6666660000000000333333333333333
0000000000000002224111143333333
0000000000000222224111333333333
0000000000000004444444411133333
3333300000000044440011111111111
3332220000000444400000000000111
4444400000004444000000000004111
4444444444044440000000000444444
1111444444444400000000004444444
3333331110000000000000000000775
3333332211111111000000000000666
4444442222222100000000033333333
4444422222222111111111113333333
4444222222222222222221113333333
4444442222222222222222244443333