10
31
20
0000000111113333332222224444444
0000001111113333333333222244444
6666660003322222224444414444444
0000000000022222244444444444444
0000000000000000000000000000001
1111100000000000000000000000011
1111111111111111111110000000011
3333333222222222222300000000033
4444444444444444433000000000333
4444444444444444433333000000011
1111112222233333333300000000011
2222211111111111111100000000001
3333333333332222222222000000001
2222222244441111110000000000333
3333344444444444000000000000775
2222224441111111000000000000666
4444441111111122222000033333333
4444444112222222222244444444444
4444444222221111114444444444444
1111111111111122223333333333333