10
31
20
1111111111111114444411444111111
0000000444444444444444444222222
6666660004444444444422222222211
0000000000044444442221111111111
1133300000033333333332222111111
1122200000022223333111111111111
1111100000022222233333331111111
1231200000044442222222111111111
2311244444433333333111111111111
1231300444442312323131222222222
1231300044044323232333223222222
4444400004024443222222333333333
4444400000022444333333211111111
1111100000022244444333333333333
1111444400022222444333333333333
1114444444433333333222222222222
1110002222233333332222222222222
1110000000000000000000000000775
1111000000000000000000000000666
1111122222222222222222222222222