10
31
20
0000000333222222222111111111111
6666660000000000000000011111111
0000000000000000000000000111111
3333333333222200000000011111111
3333333333222220000000011111111
1111111122220000000000011111111
1111111133332200000000222222222
1111111133334444400000000044444
2222211111133333334400000001111
2222221111133333334444000000111
2222211113333111122222440000044
1111222223333311112222400000044
4444444444444444444400000004444
1122211133311122100000000002222
2321312312312123132132000000222
2312312312323123123222000000775
3123123211111111113333300000666
2312313213132132312312312312312
1313123123131312321312312312312
2223123313132131231231231231231
