10
31
20
3333311111333111114444433344444
3333331113333221144444434444444
1333333113322222224444434444444
1113333333322222224433333444444
1111333333222222224333334444775
1111133330222222224333334000666
1111111100022222224333344000000
0111111000000222224333440000000
0000000000000000004444400000000
0000000000000000000000000000000
6666660000000000000000000000111
0000000000000000000000000004111
0000001111111111100000000444444
0000011111444411110000004444433
3333331114444441100220044444333
3333331111444111000022044443333
3333331111111100000222044433333
3333333111110000002220004443333
3333333222220000022220004444433
3333332222220000222222044444443